Tahun,Bulan,Cabang,Produk,Penjualan,Biaya,Profit
2020,Januari,Jakarta,Laptop,68,43,25
2020,Januari,Jakarta,Printer,235,187,48
2020,Januari,Jakarta,Monitor,220,154,66
2020,Januari,Jakarta,Aksesori,66,42,24
2020,Januari,Jakarta,Server,180,136,44
2020,Januari,Bandung,Laptop,274,171,103
2020,Januari,Bandung,Printer,193,151,42
2020,Januari,Bandung,Monitor,81,51,30
2020,Januari,Bandung,Aksesori,144,114,30
2020,Januari,Bandung,Server,62,40,22
2020,Januari,Surabaya,Laptop,226,150,76
2020,Januari,Surabaya,Printer,279,203,76
2020,Januari,Surabaya,Monitor,274,182,92
2020,Januari,Surabaya,Aksesori,236,166,70
2020,Januari,Surabaya,Server,94,61,33
2020,Januari,Medan,Laptop,178,117,61
2020,Januari,Medan,Printer,117,91,26
2020,Januari,Medan,Monitor,82,62,20
2020,Januari,Medan,Aksesori,83,62,21
2020,Januari,Medan,Server,239,163,76
2020,Januari,Denpasar,Laptop,295,232,63
2020,Januari,Denpasar,Printer,219,155,64
2020,Januari,Denpasar,Monitor,269,200,69
2020,Januari,Denpasar,Aksesori,202,159,43
2020,Januari,Denpasar,Server,116,85,31
2020,Februari,Jakarta,Laptop,85,54,31
2020,Februari,Jakarta,Printer,137,85,52
2020,Februari,Jakarta,Monitor,130,96,34
2020,Februari,Jakarta,Aksesori,237,152,85
2020,Februari,Jakarta,Server,212,139,73
2020,Februari,Bandung,Laptop,172,105,67
2020,Februari,Bandung,Printer,248,196,52
2020,Februari,Bandung,Monitor,93,65,28
2020,Februari,Bandung,Aksesori,82,65,17
2020,Februari,Bandung,Server,284,196,88
2020,Februari,Surabaya,Laptop,73,48,25
2020,Februari,Surabaya,Printer,275,189,86
2020,Februari,Surabaya,Monitor,263,195,68
2020,Februari,Surabaya,Aksesori,237,163,74
2020,Februari,Surabaya,Server,224,158,66
2020,Februari,Medan,Laptop,137,100,37
2020,Februari,Medan,Printer,245,187,58
2020,Februari,Medan,Monitor,162,112,50
2020,Februari,Medan,Aksesori,164,124,40
2020,Februari,Medan,Server,263,174,89
2020,Februari,Denpasar,Laptop,159,108,51
2020,Februari,Denpasar,Printer,264,179,85
2020,Februari,Denpasar,Monitor,295,231,64
2020,Februari,Denpasar,Aksesori,154,94,60
2020,Februari,Denpasar,Server,212,138,74
2020,Maret,Jakarta,Laptop,84,65,19
2020,Maret,Jakarta,Printer,194,144,50
2020,Maret,Jakarta,Monitor,267,174,93
2020,Maret,Jakarta,Aksesori,294,210,84
2020,Maret,Jakarta,Server,108,66,42
2020,Maret,Bandung,Laptop,241,164,77
2020,Maret,Bandung,Printer,113,72,41
2020,Maret,Bandung,Monitor,166,125,41
2020,Maret,Bandung,Aksesori,272,194,78
2020,Maret,Bandung,Server,183,120,63
2020,Maret,Surabaya,Laptop,209,159,50
2020,Maret,Surabaya,Printer,132,104,28
2020,Maret,Surabaya,Monitor,82,55,27
2020,Maret,Surabaya,Aksesori,108,69,39
2020,Maret,Surabaya,Server,123,77,46
2020,Maret,Medan,Laptop,259,159,100
2020,Maret,Medan,Printer,231,173,58
2020,Maret,Medan,Monitor,198,154,44
2020,Maret,Medan,Aksesori,252,171,81
2020,Maret,Medan,Server,193,142,51
2020,Maret,Denpasar,Laptop,235,187,48
2020,Maret,Denpasar,Printer,102,67,35
2020,Maret,Denpasar,Monitor,295,191,104
2020,Maret,Denpasar,Aksesori,82,62,20
2020,Maret,Denpasar,Server,94,64,30
2020,April,Jakarta,Laptop,119,80,39
2020,April,Jakarta,Printer,60,41,19
2020,April,Jakarta,Monitor,261,160,101
2020,April,Jakarta,Aksesori,207,148,59
2020,April,Jakarta,Server,267,212,55
2020,April,Bandung,Laptop,131,89,42
2020,April,Bandung,Printer,120,77,43
2020,April,Bandung,Monitor,226,142,84
2020,April,Bandung,Aksesori,131,101,30
2020,April,Bandung,Server,265,187,78
2020,April,Surabaya,Laptop,159,127,32
2020,April,Surabaya,Printer,130,103,27
2020,April,Surabaya,Monitor,140,90,50
2020,April,Surabaya,Aksesori,206,130,76
2020,April,Surabaya,Server,268,177,91
2020,April,Medan,Laptop,97,59,38
2020,April,Medan,Printer,108,81,27
2020,April,Medan,Monitor,283,190,93
2020,April,Medan,Aksesori,220,163,57
2020,April,Medan,Server,91,55,36
2020,April,Denpasar,Laptop,270,178,92
2020,April,Denpasar,Printer,85,60,25
2020,April,Denpasar,Monitor,203,150,53
2020,April,Denpasar,Aksesori,143,97,46
2020,April,Denpasar,Server,292,183,109
2020,Mei,Jakarta,Laptop,172,114,58
2020,Mei,Jakarta,Printer,243,166,77
2020,Mei,Jakarta,Monitor,125,83,42
2020,Mei,Jakarta,Aksesori,186,120,66
2020,Mei,Jakarta,Server,238,183,55
2020,Mei,Bandung,Laptop,288,198,90
2020,Mei,Bandung,Printer,96,73,23
2020,Mei,Bandung,Monitor,119,92,27
2020,Mei,Bandung,Aksesori,224,159,65
2020,Mei,Bandung,Server,154,104,50
2020,Mei,Surabaya,Laptop,264,186,78
2020,Mei,Surabaya,Printer,255,193,62
2020,Mei,Surabaya,Monitor,215,163,52
2020,Mei,Surabaya,Aksesori,203,153,50
2020,Mei,Surabaya,Server,289,184,105
2020,Mei,Medan,Laptop,177,128,49
2020,Mei,Medan,Printer,175,117,58
2020,Mei,Medan,Monitor,175,125,50
2020,Mei,Medan,Aksesori,178,114,64
2020,Mei,Medan,Server,122,89,33
2020,Mei,Denpasar,Laptop,63,46,17
2020,Mei,Denpasar,Printer,123,95,28
2020,Mei,Denpasar,Monitor,283,173,110
2020,Mei,Denpasar,Aksesori,179,117,62
2020,Mei,Denpasar,Server,250,155,95
2020,Juni,Jakarta,Laptop,147,108,39
2020,Juni,Jakarta,Printer,185,139,46
2020,Juni,Jakarta,Monitor,185,127,58
2020,Juni,Jakarta,Aksesori,235,143,92
2020,Juni,Jakarta,Server,284,183,101
2020,Juni,Bandung,Laptop,237,166,71
2020,Juni,Bandung,Printer,204,137,67
2020,Juni,Bandung,Monitor,277,181,96
2020,Juni,Bandung,Aksesori,77,47,30
2020,Juni,Bandung,Server,160,104,56
2020,Juni,Surabaya,Laptop,166,99,67
2020,Juni,Surabaya,Printer,265,202,63
2020,Juni,Surabaya,Monitor,221,163,58
2020,Juni,Surabaya,Aksesori,100,62,38
2020,Juni,Surabaya,Server,173,124,49
2020,Juni,Medan,Laptop,70,44,26
2020,Juni,Medan,Printer,214,146,68
2020,Juni,Medan,Monitor,147,106,41
2020,Juni,Medan,Aksesori,210,145,65
2020,Juni,Medan,Server,229,151,78
2020,Juni,Denpasar,Laptop,227,158,69
2020,Juni,Denpasar,Printer,189,139,50
2020,Juni,Denpasar,Monitor,298,228,70
2020,Juni,Denpasar,Aksesori,112,83,29
2020,Juni,Denpasar,Server,264,180,84
2020,Juli,Jakarta,Laptop,236,164,72
2020,Juli,Jakarta,Printer,232,178,54
2020,Juli,Jakarta,Monitor,74,49,25
2020,Juli,Jakarta,Aksesori,148,100,48
2020,Juli,Jakarta,Server,234,149,85
2020,Juli,Bandung,Laptop,60,44,16
2020,Juli,Bandung,Printer,143,89,54
2020,Juli,Bandung,Monitor,205,153,52
2020,Juli,Bandung,Aksesori,109,75,34
2020,Juli,Bandung,Server,238,185,53
2020,Juli,Surabaya,Laptop,192,127,65
2020,Juli,Surabaya,Printer,278,221,57
2020,Juli,Surabaya,Monitor,191,151,40
2020,Juli,Surabaya,Aksesori,162,116,46
2020,Juli,Surabaya,Server,105,82,23
2020,Juli,Medan,Laptop,159,96,63
2020,Juli,Medan,Printer,166,114,52
2020,Juli,Medan,Monitor,80,49,31
2020,Juli,Medan,Aksesori,206,123,83
2020,Juli,Medan,Server,217,141,76
2020,Juli,Denpasar,Laptop,213,163,50
2020,Juli,Denpasar,Printer,292,212,80
2020,Juli,Denpasar,Monitor,249,162,87
2020,Juli,Denpasar,Aksesori,122,75,47
2020,Juli,Denpasar,Server,299,219,80
2020,Agustus,Jakarta,Laptop,79,54,25
2020,Agustus,Jakarta,Printer,173,114,59
2020,Agustus,Jakarta,Monitor,221,168,53
2020,Agustus,Jakarta,Aksesori,188,142,46
2020,Agustus,Jakarta,Server,142,92,50
2020,Agustus,Bandung,Laptop,71,55,16
2020,Agustus,Bandung,Printer,115,80,35
2020,Agustus,Bandung,Monitor,115,69,46
2020,Agustus,Bandung,Aksesori,189,122,67
2020,Agustus,Bandung,Server,290,207,83
2020,Agustus,Surabaya,Laptop,176,131,45
2020,Agustus,Surabaya,Printer,288,201,87
2020,Agustus,Surabaya,Monitor,61,41,20
2020,Agustus,Surabaya,Aksesori,214,146,68
2020,Agustus,Surabaya,Server,197,132,65
2020,Agustus,Medan,Laptop,241,148,93
2020,Agustus,Medan,Printer,76,60,16
2020,Agustus,Medan,Monitor,60,42,18
2020,Agustus,Medan,Aksesori,181,124,57
2020,Agustus,Medan,Server,156,114,42
2020,Agustus,Denpasar,Laptop,170,102,68
2020,Agustus,Denpasar,Printer,292,201,91
2020,Agustus,Denpasar,Monitor,255,201,54
2020,Agustus,Denpasar,Aksesori,110,77,33
2020,Agustus,Denpasar,Server,150,94,56
2020,September,Jakarta,Laptop,234,184,50
2020,September,Jakarta,Printer,171,108,63
2020,September,Jakarta,Monitor,123,93,30
2020,September,Jakarta,Aksesori,83,53,30
2020,September,Jakarta,Server,77,48,29
2020,September,Bandung,Laptop,64,42,22
2020,September,Bandung,Printer,176,106,70
2020,September,Bandung,Monitor,197,150,47
2020,September,Bandung,Aksesori,149,104,45
2020,September,Bandung,Server,145,94,51
2020,September,Surabaya,Laptop,291,188,103
2020,September,Surabaya,Printer,99,67,32
2020,September,Surabaya,Monitor,130,97,33
2020,September,Surabaya,Aksesori,263,202,61
2020,September,Surabaya,Server,189,128,61
2020,September,Medan,Laptop,86,52,34
2020,September,Medan,Printer,110,68,42
2020,September,Medan,Monitor,190,140,50
2020,September,Medan,Aksesori,66,44,22
2020,September,Medan,Server,266,183,83
2020,September,Denpasar,Laptop,193,130,63
2020,September,Denpasar,Printer,199,142,57
2020,September,Denpasar,Monitor,267,167,100
2020,September,Denpasar,Aksesori,180,136,44
2020,September,Denpasar,Server,195,117,78
2020,Oktober,Jakarta,Laptop,156,99,57
2020,Oktober,Jakarta,Printer,160,108,52
2020,Oktober,Jakarta,Monitor,213,162,51
2020,Oktober,Jakarta,Aksesori,220,132,88
2020,Oktober,Jakarta,Server,281,222,59
2020,Oktober,Bandung,Laptop,117,86,31
2020,Oktober,Bandung,Printer,261,164,97
2020,Oktober,Bandung,Monitor,127,86,41
2020,Oktober,Bandung,Aksesori,158,98,60
2020,Oktober,Bandung,Server,192,126,66
2020,Oktober,Surabaya,Laptop,67,53,14
2020,Oktober,Surabaya,Printer,127,91,36
2020,Oktober,Surabaya,Monitor,223,162,61
2020,Oktober,Surabaya,Aksesori,293,180,113
2020,Oktober,Surabaya,Server,270,198,72
2020,Oktober,Medan,Laptop,296,221,75
2020,Oktober,Medan,Printer,267,189,78
2020,Oktober,Medan,Monitor,154,103,51
2020,Oktober,Medan,Aksesori,132,99,33
2020,Oktober,Medan,Server,174,116,58
2020,Oktober,Denpasar,Laptop,188,128,60
2020,Oktober,Denpasar,Printer,123,94,29
2020,Oktober,Denpasar,Monitor,294,223,71
2020,Oktober,Denpasar,Aksesori,72,45,27
2020,Oktober,Denpasar,Server,147,91,56
2020,November,Jakarta,Laptop,100,64,36
2020,November,Jakarta,Printer,259,202,57
2020,November,Jakarta,Monitor,188,120,68
2020,November,Jakarta,Aksesori,79,61,18
2020,November,Jakarta,Server,100,78,22
2020,November,Bandung,Laptop,220,156,64
2020,November,Bandung,Printer,161,102,59
2020,November,Bandung,Monitor,244,162,82
2020,November,Bandung,Aksesori,119,82,37
2020,November,Bandung,Server,264,163,101
2020,November,Surabaya,Laptop,103,78,25
2020,November,Surabaya,Printer,74,56,18
2020,November,Surabaya,Monitor,86,59,27
2020,November,Surabaya,Aksesori,95,69,26
2020,November,Surabaya,Server,219,161,58
2020,November,Medan,Laptop,285,189,96
2020,November,Medan,Printer,104,76,28
2020,November,Medan,Monitor,241,191,50
2020,November,Medan,Aksesori,143,88,55
2020,November,Medan,Server,89,66,23
2020,November,Denpasar,Laptop,252,152,100
2020,November,Denpasar,Printer,253,170,83
2020,November,Denpasar,Monitor,244,152,92
2020,November,Denpasar,Aksesori,173,131,42
2020,November,Denpasar,Server,283,213,70
2020,Desember,Jakarta,Laptop,85,66,19
2020,Desember,Jakarta,Printer,281,214,67
2020,Desember,Jakarta,Monitor,81,58,23
2020,Desember,Jakarta,Aksesori,186,144,42
2020,Desember,Jakarta,Server,90,59,31
2020,Desember,Bandung,Laptop,269,180,89
2020,Desember,Bandung,Printer,75,51,24
2020,Desember,Bandung,Monitor,70,44,26
2020,Desember,Bandung,Aksesori,172,114,58
2020,Desember,Bandung,Server,287,200,87
2020,Desember,Surabaya,Laptop,195,127,68
2020,Desember,Surabaya,Printer,119,84,35
2020,Desember,Surabaya,Monitor,295,229,66
2020,Desember,Surabaya,Aksesori,126,93,33
2020,Desember,Surabaya,Server,132,105,27
2020,Desember,Medan,Laptop,174,109,65
2020,Desember,Medan,Printer,60,38,22
2020,Desember,Medan,Monitor,186,129,57
2020,Desember,Medan,Aksesori,252,183,69
2020,Desember,Medan,Server,79,59,20
2020,Desember,Denpasar,Laptop,121,83,38
2020,Desember,Denpasar,Printer,273,191,82
2020,Desember,Denpasar,Monitor,168,118,50
2020,Desember,Denpasar,Aksesori,267,200,67
2020,Desember,Denpasar,Server,91,55,36
2021,Januari,Jakarta,Laptop,226,137,89
2021,Januari,Jakarta,Printer,118,92,26
2021,Januari,Jakarta,Monitor,208,150,58
2021,Januari,Jakarta,Aksesori,126,96,30
2021,Januari,Jakarta,Server,115,70,45
2021,Januari,Bandung,Laptop,233,172,61
2021,Januari,Bandung,Printer,90,54,36
2021,Januari,Bandung,Monitor,111,71,40
2021,Januari,Bandung,Aksesori,195,123,72
2021,Januari,Bandung,Server,298,196,102
2021,Januari,Surabaya,Laptop,134,88,46
2021,Januari,Surabaya,Printer,222,153,69
2021,Januari,Surabaya,Monitor,101,63,38
2021,Januari,Surabaya,Aksesori,268,196,72
2021,Januari,Surabaya,Server,177,132,45
2021,Januari,Medan,Laptop,69,41,28
2021,Januari,Medan,Printer,148,103,45
2021,Januari,Medan,Monitor,227,153,74
2021,Januari,Medan,Aksesori,104,75,29
2021,Januari,Medan,Server,275,180,95
2021,Januari,Denpasar,Laptop,182,138,44
2021,Januari,Denpasar,Printer,166,104,62
2021,Januari,Denpasar,Monitor,101,61,40
2021,Januari,Denpasar,Aksesori,275,178,97
2021,Januari,Denpasar,Server,126,79,47
2021,Februari,Jakarta,Laptop,244,187,57
2021,Februari,Jakarta,Printer,270,189,81
2021,Februari,Jakarta,Monitor,280,188,92
2021,Februari,Jakarta,Aksesori,66,42,24
2021,Februari,Jakarta,Server,246,173,73
2021,Februari,Bandung,Laptop,181,114,67
2021,Februari,Bandung,Printer,100,77,23
2021,Februari,Bandung,Monitor,191,145,46
2021,Februari,Bandung,Aksesori,198,133,65
2021,Februari,Bandung,Server,256,166,90
2021,Februari,Surabaya,Laptop,71,50,21
2021,Februari,Surabaya,Printer,61,39,22
2021,Februari,Surabaya,Monitor,188,115,73
2021,Februari,Surabaya,Aksesori,295,181,114
2021,Februari,Surabaya,Server,219,148,71
2021,Februari,Medan,Laptop,265,168,97
2021,Februari,Medan,Printer,281,217,64
2021,Februari,Medan,Monitor,183,137,46
2021,Februari,Medan,Aksesori,196,145,51
2021,Februari,Medan,Server,275,201,74
2021,Februari,Denpasar,Laptop,296,203,93
2021,Februari,Denpasar,Printer,76,47,29
2021,Februari,Denpasar,Monitor,169,121,48
2021,Februari,Denpasar,Aksesori,198,122,76
2021,Februari,Denpasar,Server,192,132,60
2021,Maret,Jakarta,Laptop,274,176,98
2021,Maret,Jakarta,Printer,235,184,51
2021,Maret,Jakarta,Monitor,210,167,43
2021,Maret,Jakarta,Aksesori,215,157,58
2021,Maret,Jakarta,Server,241,188,53
2021,Maret,Bandung,Laptop,159,111,48
2021,Maret,Bandung,Printer,284,211,73
2021,Maret,Bandung,Monitor,181,136,45
2021,Maret,Bandung,Aksesori,181,128,53
2021,Maret,Bandung,Server,174,110,64
2021,Maret,Surabaya,Laptop,182,137,45
2021,Maret,Surabaya,Printer,188,140,48
2021,Maret,Surabaya,Monitor,208,150,58
2021,Maret,Surabaya,Aksesori,171,132,39
2021,Maret,Surabaya,Server,244,183,61
2021,Maret,Medan,Laptop,119,80,39
2021,Maret,Medan,Printer,178,117,61
2021,Maret,Medan,Monitor,120,86,34
2021,Maret,Medan,Aksesori,251,153,98
2021,Maret,Medan,Server,183,127,56
2021,Maret,Denpasar,Laptop,297,215,82
2021,Maret,Denpasar,Printer,257,183,74
2021,Maret,Denpasar,Monitor,69,51,18
2021,Maret,Denpasar,Aksesori,252,172,80
2021,Maret,Denpasar,Server,237,161,76
2021,April,Jakarta,Laptop,78,49,29
2021,April,Jakarta,Printer,116,92,24
2021,April,Jakarta,Monitor,268,167,101
2021,April,Jakarta,Aksesori,214,170,44
2021,April,Jakarta,Server,286,204,82
2021,April,Bandung,Laptop,222,146,76
2021,April,Bandung,Printer,72,54,18
2021,April,Bandung,Monitor,84,51,33
2021,April,Bandung,Aksesori,234,148,86
2021,April,Bandung,Server,295,178,117
2021,April,Surabaya,Laptop,219,138,81
2021,April,Surabaya,Printer,118,89,29
2021,April,Surabaya,Monitor,74,48,26
2021,April,Surabaya,Aksesori,197,143,54
2021,April,Surabaya,Server,90,55,35
2021,April,Medan,Laptop,141,93,48
2021,April,Medan,Printer,105,73,32
2021,April,Medan,Monitor,65,45,20
2021,April,Medan,Aksesori,185,115,70
2021,April,Medan,Server,210,155,55
2021,April,Denpasar,Laptop,288,174,114
2021,April,Denpasar,Printer,245,183,62
2021,April,Denpasar,Monitor,184,132,52
2021,April,Denpasar,Aksesori,107,65,42
2021,April,Denpasar,Server,104,75,29
2021,Mei,Jakarta,Laptop,68,46,22
2021,Mei,Jakarta,Printer,68,51,17
2021,Mei,Jakarta,Monitor,88,60,28
2021,Mei,Jakarta,Aksesori,274,214,60
2021,Mei,Jakarta,Server,96,61,35
2021,Mei,Bandung,Laptop,224,167,57
2021,Mei,Bandung,Printer,294,185,109
2021,Mei,Bandung,Monitor,175,133,42
2021,Mei,Bandung,Aksesori,144,88,56
2021,Mei,Bandung,Server,209,165,44
2021,Mei,Surabaya,Laptop,71,53,18
2021,Mei,Surabaya,Printer,97,69,28
2021,Mei,Surabaya,Monitor,234,143,91
2021,Mei,Surabaya,Aksesori,125,83,42
2021,Mei,Surabaya,Server,109,74,35
2021,Mei,Medan,Laptop,290,225,65
2021,Mei,Medan,Printer,171,135,36
2021,Mei,Medan,Monitor,201,123,78
2021,Mei,Medan,Aksesori,254,153,101
2021,Mei,Medan,Server,67,51,16
2021,Mei,Denpasar,Laptop,212,155,57
2021,Mei,Denpasar,Printer,146,115,31
2021,Mei,Denpasar,Monitor,89,68,21
2021,Mei,Denpasar,Aksesori,103,74,29
2021,Mei,Denpasar,Server,213,135,78
2021,Juni,Jakarta,Laptop,164,114,50
2021,Juni,Jakarta,Printer,175,108,67
2021,Juni,Jakarta,Monitor,167,120,47
2021,Juni,Jakarta,Aksesori,60,37,23
2021,Juni,Jakarta,Server,127,101,26
2021,Juni,Bandung,Laptop,162,109,53
2021,Juni,Bandung,Printer,81,58,23
2021,Juni,Bandung,Monitor,113,90,23
2021,Juni,Bandung,Aksesori,270,162,108
2021,Juni,Bandung,Server,214,135,79
2021,Juni,Surabaya,Laptop,214,130,84
2021,Juni,Surabaya,Printer,111,67,44
2021,Juni,Surabaya,Monitor,213,157,56
2021,Juni,Surabaya,Aksesori,182,123,59
2021,Juni,Surabaya,Server,96,59,37
2021,Juni,Medan,Laptop,116,85,31
2021,Juni,Medan,Printer,91,63,28
2021,Juni,Medan,Monitor,120,88,32
2021,Juni,Medan,Aksesori,225,163,62
2021,Juni,Medan,Server,80,53,27
2021,Juni,Denpasar,Laptop,93,59,34
2021,Juni,Denpasar,Printer,135,98,37
2021,Juni,Denpasar,Monitor,62,47,15
2021,Juni,Denpasar,Aksesori,263,181,82
2021,Juni,Denpasar,Server,201,154,47
2021,Juli,Jakarta,Laptop,194,149,45
2021,Juli,Jakarta,Printer,259,186,73
2021,Juli,Jakarta,Monitor,222,153,69
2021,Juli,Jakarta,Aksesori,75,59,16
2021,Juli,Jakarta,Server,253,188,65
2021,Juli,Bandung,Laptop,209,138,71
2021,Juli,Bandung,Printer,78,55,23
2021,Juli,Bandung,Monitor,224,163,61
2021,Juli,Bandung,Aksesori,75,47,28
2021,Juli,Bandung,Server,248,186,62
2021,Juli,Surabaya,Laptop,72,48,24
2021,Juli,Surabaya,Printer,121,79,42
2021,Juli,Surabaya,Monitor,275,188,87
2021,Juli,Surabaya,Aksesori,140,96,44
2021,Juli,Surabaya,Server,263,183,80
2021,Juli,Medan,Laptop,228,142,86
2021,Juli,Medan,Printer,256,192,64
2021,Juli,Medan,Monitor,283,201,82
2021,Juli,Medan,Aksesori,137,102,35
2021,Juli,Medan,Server,209,136,73
2021,Juli,Denpasar,Laptop,190,134,56
2021,Juli,Denpasar,Printer,275,169,106
2021,Juli,Denpasar,Monitor,270,188,82
2021,Juli,Denpasar,Aksesori,214,140,74
2021,Juli,Denpasar,Server,246,183,63
2021,Agustus,Jakarta,Laptop,212,132,80
2021,Agustus,Jakarta,Printer,90,63,27
2021,Agustus,Jakarta,Monitor,169,109,60
2021,Agustus,Jakarta,Aksesori,159,108,51
2021,Agustus,Jakarta,Server,65,43,22
2021,Agustus,Bandung,Laptop,64,44,20
2021,Agustus,Bandung,Printer,119,89,30
2021,Agustus,Bandung,Monitor,102,68,34
2021,Agustus,Bandung,Aksesori,271,198,73
2021,Agustus,Bandung,Server,237,159,78
2021,Agustus,Surabaya,Laptop,133,105,28
2021,Agustus,Surabaya,Printer,163,115,48
2021,Agustus,Surabaya,Monitor,154,120,34
2021,Agustus,Surabaya,Aksesori,216,153,63
2021,Agustus,Surabaya,Server,137,90,47
2021,Agustus,Medan,Laptop,230,144,86
2021,Agustus,Medan,Printer,198,127,71
2021,Agustus,Medan,Monitor,184,138,46
2021,Agustus,Medan,Aksesori,82,54,28
2021,Agustus,Medan,Server,221,165,56
2021,Agustus,Denpasar,Laptop,149,97,52
2021,Agustus,Denpasar,Printer,199,140,59
2021,Agustus,Denpasar,Monitor,178,114,64
2021,Agustus,Denpasar,Aksesori,224,159,65
2021,Agustus,Denpasar,Server,254,156,98
2021,September,Jakarta,Laptop,154,113,41
2021,September,Jakarta,Printer,168,133,35
2021,September,Jakarta,Monitor,165,111,54
2021,September,Jakarta,Aksesori,173,119,54
2021,September,Jakarta,Server,135,81,54
2021,September,Bandung,Laptop,92,62,30
2021,September,Bandung,Printer,100,70,30
2021,September,Bandung,Monitor,193,123,70
2021,September,Bandung,Aksesori,236,178,58
2021,September,Bandung,Server,245,176,69
2021,September,Surabaya,Laptop,209,138,71
2021,September,Surabaya,Printer,295,231,64
2021,September,Surabaya,Monitor,61,37,24
2021,September,Surabaya,Aksesori,178,132,46
2021,September,Surabaya,Server,246,160,86
2021,September,Medan,Laptop,244,169,75
2021,September,Medan,Printer,123,80,43
2021,September,Medan,Monitor,217,151,66
2021,September,Medan,Aksesori,276,215,61
2021,September,Medan,Server,154,94,60
2021,September,Denpasar,Laptop,254,160,94
2021,September,Denpasar,Printer,65,45,20
2021,September,Denpasar,Monitor,66,46,20
2021,September,Denpasar,Aksesori,262,179,83
2021,September,Denpasar,Server,276,206,70
2021,Oktober,Jakarta,Laptop,141,94,47
2021,Oktober,Jakarta,Printer,123,86,37
2021,Oktober,Jakarta,Monitor,269,193,76
2021,Oktober,Jakarta,Aksesori,217,153,64
2021,Oktober,Jakarta,Server,285,184,101
2021,Oktober,Bandung,Laptop,94,67,27
2021,Oktober,Bandung,Printer,148,95,53
2021,Oktober,Bandung,Monitor,273,206,67
2021,Oktober,Bandung,Aksesori,288,190,98
2021,Oktober,Bandung,Server,150,113,37
2021,Oktober,Surabaya,Laptop,158,98,60
2021,Oktober,Surabaya,Printer,116,75,41
2021,Oktober,Surabaya,Monitor,101,72,29
2021,Oktober,Surabaya,Aksesori,294,226,68
2021,Oktober,Surabaya,Server,138,108,30
2021,Oktober,Medan,Laptop,214,129,85
2021,Oktober,Medan,Printer,67,42,25
2021,Oktober,Medan,Monitor,211,150,61
2021,Oktober,Medan,Aksesori,169,108,61
2021,Oktober,Medan,Server,268,204,64
2021,Oktober,Denpasar,Laptop,176,121,55
2021,Oktober,Denpasar,Printer,90,65,25
2021,Oktober,Denpasar,Monitor,229,169,60
2021,Oktober,Denpasar,Aksesori,86,52,34
2021,Oktober,Denpasar,Server,107,75,32
2021,November,Jakarta,Laptop,292,212,80
2021,November,Jakarta,Printer,204,157,47
2021,November,Jakarta,Monitor,86,58,28
2021,November,Jakarta,Aksesori,229,140,89
2021,November,Jakarta,Server,260,206,54
2021,November,Bandung,Laptop,151,95,56
2021,November,Bandung,Printer,60,47,13
2021,November,Bandung,Monitor,67,44,23
2021,November,Bandung,Aksesori,272,213,59
2021,November,Bandung,Server,238,174,64
2021,November,Surabaya,Laptop,297,226,71
2021,November,Surabaya,Printer,145,111,34
2021,November,Surabaya,Monitor,165,103,62
2021,November,Surabaya,Aksesori,148,100,48
2021,November,Surabaya,Server,268,210,58
2021,November,Medan,Laptop,252,201,51
2021,November,Medan,Printer,79,55,24
2021,November,Medan,Monitor,139,94,45
2021,November,Medan,Aksesori,171,121,50
2021,November,Medan,Server,259,162,97
2021,November,Denpasar,Laptop,141,103,38
2021,November,Denpasar,Printer,176,137,39
2021,November,Denpasar,Monitor,278,201,77
2021,November,Denpasar,Aksesori,91,61,30
2021,November,Denpasar,Server,76,53,23
2021,Desember,Jakarta,Laptop,216,170,46
2021,Desember,Jakarta,Printer,266,173,93
2021,Desember,Jakarta,Monitor,66,51,15
2021,Desember,Jakarta,Aksesori,226,177,49
2021,Desember,Jakarta,Server,82,56,26
2021,Desember,Bandung,Laptop,283,215,68
2021,Desember,Bandung,Printer,258,170,88
2021,Desember,Bandung,Monitor,144,94,50
2021,Desember,Bandung,Aksesori,65,50,15
2021,Desember,Bandung,Server,129,98,31
2021,Desember,Surabaya,Laptop,127,99,28
2021,Desember,Surabaya,Printer,274,193,81
2021,Desember,Surabaya,Monitor,231,152,79
2021,Desember,Surabaya,Aksesori,251,189,62
2021,Desember,Surabaya,Server,263,161,102
2021,Desember,Medan,Laptop,297,197,100
2021,Desember,Medan,Printer,145,98,47
2021,Desember,Medan,Monitor,99,65,34
2021,Desember,Medan,Aksesori,182,132,50
2021,Desember,Medan,Server,188,140,48
2021,Desember,Denpasar,Laptop,280,196,84
2021,Desember,Denpasar,Printer,208,136,72
2021,Desember,Denpasar,Monitor,219,157,62
2021,Desember,Denpasar,Aksesori,215,165,50
2021,Desember,Denpasar,Server,171,132,39
2022,Januari,Jakarta,Laptop,300,203,97
2022,Januari,Jakarta,Printer,265,161,104
2022,Januari,Jakarta,Monitor,239,175,64
2022,Januari,Jakarta,Aksesori,203,150,53
2022,Januari,Jakarta,Server,136,104,32
2022,Januari,Bandung,Laptop,236,173,63
2022,Januari,Bandung,Printer,267,181,86
2022,Januari,Bandung,Monitor,159,109,50
2022,Januari,Bandung,Aksesori,177,131,46
2022,Januari,Bandung,Server,88,54,34
2022,Januari,Surabaya,Laptop,94,65,29
2022,Januari,Surabaya,Printer,276,194,82
2022,Januari,Surabaya,Monitor,122,95,27
2022,Januari,Surabaya,Aksesori,133,105,28
2022,Januari,Surabaya,Server,76,45,31
2022,Januari,Medan,Laptop,209,167,42
2022,Januari,Medan,Printer,228,159,69
2022,Januari,Medan,Monitor,216,146,70
2022,Januari,Medan,Aksesori,170,102,68
2022,Januari,Medan,Server,170,108,62
2022,Januari,Denpasar,Laptop,263,204,59
2022,Januari,Denpasar,Printer,210,152,58
2022,Januari,Denpasar,Monitor,90,67,23
2022,Januari,Denpasar,Aksesori,134,93,41
2022,Januari,Denpasar,Server,289,200,89
2022,Februari,Jakarta,Laptop,276,202,74
2022,Februari,Jakarta,Printer,206,142,64
2022,Februari,Jakarta,Monitor,86,66,20
2022,Februari,Jakarta,Aksesori,243,181,62
2022,Februari,Jakarta,Server,94,73,21
2022,Februari,Bandung,Laptop,258,179,79
2022,Februari,Bandung,Printer,213,151,62
2022,Februari,Bandung,Monitor,184,117,67
2022,Februari,Bandung,Aksesori,119,72,47
2022,Februari,Bandung,Server,213,154,59
2022,Februari,Surabaya,Laptop,208,153,55
2022,Februari,Surabaya,Printer,273,179,94
2022,Februari,Surabaya,Monitor,123,86,37
2022,Februari,Surabaya,Aksesori,68,42,26
2022,Februari,Surabaya,Server,267,198,69
2022,Februari,Medan,Laptop,131,89,42
2022,Februari,Medan,Printer,245,175,70
2022,Februari,Medan,Monitor,72,44,28
2022,Februari,Medan,Aksesori,88,55,33
2022,Februari,Medan,Server,152,96,56
2022,Februari,Denpasar,Laptop,171,107,64
2022,Februari,Denpasar,Printer,74,58,16
2022,Februari,Denpasar,Monitor,206,144,62
2022,Februari,Denpasar,Aksesori,143,88,55
2022,Februari,Denpasar,Server,203,142,61
2022,Maret,Jakarta,Laptop,279,188,91
2022,Maret,Jakarta,Printer,291,223,68
2022,Maret,Jakarta,Monitor,215,137,78
2022,Maret,Jakarta,Aksesori,251,181,70
2022,Maret,Jakarta,Server,155,122,33
2022,Maret,Bandung,Laptop,66,48,18
2022,Maret,Bandung,Printer,85,58,27
2022,Maret,Bandung,Monitor,168,129,39
2022,Maret,Bandung,Aksesori,118,80,38
2022,Maret,Bandung,Server,89,65,24
2022,Maret,Surabaya,Laptop,192,119,73
2022,Maret,Surabaya,Printer,216,143,73
2022,Maret,Surabaya,Monitor,67,50,17
2022,Maret,Surabaya,Aksesori,201,148,53
2022,Maret,Surabaya,Server,181,143,38
2022,Maret,Medan,Laptop,151,104,47
2022,Maret,Medan,Printer,257,205,52
2022,Maret,Medan,Monitor,213,160,53
2022,Maret,Medan,Aksesori,214,129,85
2022,Maret,Medan,Server,162,127,35
2022,Maret,Denpasar,Laptop,161,104,57
2022,Maret,Denpasar,Printer,144,86,58
2022,Maret,Denpasar,Monitor,151,92,59
2022,Maret,Denpasar,Aksesori,140,101,39
2022,Maret,Denpasar,Server,233,165,68
2022,April,Jakarta,Laptop,158,104,54
2022,April,Jakarta,Printer,213,162,51
2022,April,Jakarta,Monitor,66,49,17
2022,April,Jakarta,Aksesori,94,57,37
2022,April,Jakarta,Server,261,197,64
2022,April,Bandung,Laptop,264,211,53
2022,April,Bandung,Printer,282,180,102
2022,April,Bandung,Monitor,247,154,93
2022,April,Bandung,Aksesori,248,179,69
2022,April,Bandung,Server,118,81,37
2022,April,Surabaya,Laptop,178,121,57
2022,April,Surabaya,Printer,272,172,100
2022,April,Surabaya,Monitor,180,137,43
2022,April,Surabaya,Aksesori,88,60,28
2022,April,Surabaya,Server,290,220,70
2022,April,Medan,Laptop,204,140,64
2022,April,Medan,Printer,204,159,45
2022,April,Medan,Monitor,147,91,56
2022,April,Medan,Aksesori,83,60,23
2022,April,Medan,Server,110,70,40
2022,April,Denpasar,Laptop,71,54,17
2022,April,Denpasar,Printer,81,52,29
2022,April,Denpasar,Monitor,180,126,54
2022,April,Denpasar,Aksesori,125,86,39
2022,April,Denpasar,Server,90,58,32
2022,Mei,Jakarta,Laptop,60,39,21
2022,Mei,Jakarta,Printer,228,146,82
2022,Mei,Jakarta,Monitor,152,105,47
2022,Mei,Jakarta,Aksesori,141,92,49
2022,Mei,Jakarta,Server,138,84,54
2022,Mei,Bandung,Laptop,163,121,42
2022,Mei,Bandung,Printer,76,51,25
2022,Mei,Bandung,Monitor,132,100,32
2022,Mei,Bandung,Aksesori,221,141,80
2022,Mei,Bandung,Server,293,233,60
2022,Mei,Surabaya,Laptop,211,156,55
2022,Mei,Surabaya,Printer,156,112,44
2022,Mei,Surabaya,Monitor,105,78,27
2022,Mei,Surabaya,Aksesori,252,164,88
2022,Mei,Surabaya,Server,176,110,66
2022,Mei,Medan,Laptop,248,173,75
2022,Mei,Medan,Printer,250,163,87
2022,Mei,Medan,Monitor,173,123,50
2022,Mei,Medan,Aksesori,74,58,16
2022,Mei,Medan,Server,289,197,92
2022,Mei,Denpasar,Laptop,115,79,36
2022,Mei,Denpasar,Printer,94,58,36
2022,Mei,Denpasar,Monitor,160,97,63
2022,Mei,Denpasar,Aksesori,66,49,17
2022,Mei,Denpasar,Server,215,136,79
2022,Juni,Jakarta,Laptop,223,168,55
2022,Juni,Jakarta,Printer,277,187,90
2022,Juni,Jakarta,Monitor,245,166,79
2022,Juni,Jakarta,Aksesori,170,103,67
2022,Juni,Jakarta,Server,170,106,64
2022,Juni,Bandung,Laptop,128,83,45
2022,Juni,Bandung,Printer,87,55,32
2022,Juni,Bandung,Monitor,233,143,90
2022,Juni,Bandung,Aksesori,244,169,75
2022,Juni,Bandung,Server,76,56,20
2022,Juni,Surabaya,Laptop,79,58,21
2022,Juni,Surabaya,Printer,212,163,49
2022,Juni,Surabaya,Monitor,163,110,53
2022,Juni,Surabaya,Aksesori,180,134,46
2022,Juni,Surabaya,Server,159,116,43
2022,Juni,Medan,Laptop,150,103,47
2022,Juni,Medan,Printer,287,196,91
2022,Juni,Medan,Monitor,120,88,32
2022,Juni,Medan,Aksesori,147,114,33
2022,Juni,Medan,Server,176,127,49
2022,Juni,Denpasar,Laptop,86,56,30
2022,Juni,Denpasar,Printer,243,184,59
2022,Juni,Denpasar,Monitor,120,80,40
2022,Juni,Denpasar,Aksesori,76,60,16
2022,Juni,Denpasar,Server,297,220,77
2022,Juli,Jakarta,Laptop,117,71,46
2022,Juli,Jakarta,Printer,274,198,76
2022,Juli,Jakarta,Monitor,238,163,75
2022,Juli,Jakarta,Aksesori,123,89,34
2022,Juli,Jakarta,Server,198,122,76
2022,Juli,Bandung,Laptop,262,207,55
2022,Juli,Bandung,Printer,261,157,104
2022,Juli,Bandung,Monitor,271,179,92
2022,Juli,Bandung,Aksesori,131,98,33
2022,Juli,Bandung,Server,63,45,18
2022,Juli,Surabaya,Laptop,285,205,80
2022,Juli,Surabaya,Printer,294,212,82
2022,Juli,Surabaya,Monitor,236,151,85
2022,Juli,Surabaya,Aksesori,145,112,33
2022,Juli,Surabaya,Server,192,128,64
2022,Juli,Medan,Laptop,198,148,50
2022,Juli,Medan,Printer,253,154,99
2022,Juli,Medan,Monitor,175,112,63
2022,Juli,Medan,Aksesori,119,85,34
2022,Juli,Medan,Server,157,112,45
2022,Juli,Denpasar,Laptop,117,90,27
2022,Juli,Denpasar,Printer,153,121,32
2022,Juli,Denpasar,Monitor,190,118,72
2022,Juli,Denpasar,Aksesori,228,152,76
2022,Juli,Denpasar,Server,190,144,46
2022,Agustus,Jakarta,Laptop,139,95,44
2022,Agustus,Jakarta,Printer,165,121,44
2022,Agustus,Jakarta,Monitor,249,152,97
2022,Agustus,Jakarta,Aksesori,175,105,70
2022,Agustus,Jakarta,Server,78,57,21
2022,Agustus,Bandung,Laptop,86,66,20
2022,Agustus,Bandung,Printer,231,165,66
2022,Agustus,Bandung,Monitor,290,211,79
2022,Agustus,Bandung,Aksesori,272,182,90
2022,Agustus,Bandung,Server,225,179,46
2022,Agustus,Surabaya,Laptop,258,193,65
2022,Agustus,Surabaya,Printer,119,90,29
2022,Agustus,Surabaya,Monitor,271,196,75
2022,Agustus,Surabaya,Aksesori,239,189,50
2022,Agustus,Surabaya,Server,130,85,45
2022,Agustus,Medan,Laptop,213,155,58
2022,Agustus,Medan,Printer,115,75,40
2022,Agustus,Medan,Monitor,109,69,40
2022,Agustus,Medan,Aksesori,245,165,80
2022,Agustus,Medan,Server,266,169,97
2022,Agustus,Denpasar,Laptop,186,128,58
2022,Agustus,Denpasar,Printer,288,177,111
2022,Agustus,Denpasar,Monitor,157,95,62
2022,Agustus,Denpasar,Aksesori,117,90,27
2022,Agustus,Denpasar,Server,115,72,43
2022,September,Jakarta,Laptop,112,89,23
2022,September,Jakarta,Printer,114,70,44
2022,September,Jakarta,Monitor,183,117,66
2022,September,Jakarta,Aksesori,121,87,34
2022,September,Jakarta,Server,63,40,23
2022,September,Bandung,Laptop,199,156,43
2022,September,Bandung,Printer,81,49,32
2022,September,Bandung,Monitor,129,80,49
2022,September,Bandung,Aksesori,64,50,14
2022,September,Bandung,Server,219,150,69
2022,September,Surabaya,Laptop,242,176,66
2022,September,Surabaya,Printer,224,178,46
2022,September,Surabaya,Monitor,70,43,27
2022,September,Surabaya,Aksesori,129,86,43
2022,September,Surabaya,Server,103,78,25
2022,September,Medan,Laptop,300,233,67
2022,September,Medan,Printer,225,178,47
2022,September,Medan,Monitor,164,123,41
2022,September,Medan,Aksesori,73,44,29
2022,September,Medan,Server,196,138,58
2022,September,Denpasar,Laptop,98,61,37
2022,September,Denpasar,Printer,116,86,30
2022,September,Denpasar,Monitor,67,48,19
2022,September,Denpasar,Aksesori,288,198,90
2022,September,Denpasar,Server,73,51,22
2022,Oktober,Jakarta,Laptop,92,72,20
2022,Oktober,Jakarta,Printer,64,48,16
2022,Oktober,Jakarta,Monitor,73,51,22
2022,Oktober,Jakarta,Aksesori,164,111,53
2022,Oktober,Jakarta,Server,193,117,76
2022,Oktober,Bandung,Laptop,170,135,35
2022,Oktober,Bandung,Printer,96,73,23
2022,Oktober,Bandung,Monitor,186,122,64
2022,Oktober,Bandung,Aksesori,153,102,51
2022,Oktober,Bandung,Server,228,158,70
2022,Oktober,Surabaya,Laptop,142,108,34
2022,Oktober,Surabaya,Printer,291,177,114
2022,Oktober,Surabaya,Monitor,299,188,111
2022,Oktober,Surabaya,Aksesori,188,139,49
2022,Oktober,Surabaya,Server,86,58,28
2022,Oktober,Medan,Laptop,290,217,73
2022,Oktober,Medan,Printer,272,167,105
2022,Oktober,Medan,Monitor,208,161,47
2022,Oktober,Medan,Aksesori,144,104,40
2022,Oktober,Medan,Server,259,183,76
2022,Oktober,Denpasar,Laptop,139,93,46
2022,Oktober,Denpasar,Printer,211,140,71
2022,Oktober,Denpasar,Monitor,185,123,62
2022,Oktober,Denpasar,Aksesori,111,83,28
2022,Oktober,Denpasar,Server,254,168,86
2022,November,Jakarta,Laptop,116,81,35
2022,November,Jakarta,Printer,84,53,31
2022,November,Jakarta,Monitor,151,91,60
2022,November,Jakarta,Aksesori,179,128,51
2022,November,Jakarta,Server,241,146,95
2022,November,Bandung,Laptop,227,176,51
2022,November,Bandung,Printer,237,157,80
2022,November,Bandung,Monitor,184,146,38
2022,November,Bandung,Aksesori,134,82,52
2022,November,Bandung,Server,183,125,58
2022,November,Surabaya,Laptop,293,208,85
2022,November,Surabaya,Printer,145,109,36
2022,November,Surabaya,Monitor,153,121,32
2022,November,Surabaya,Aksesori,234,154,80
2022,November,Surabaya,Server,213,143,70
2022,November,Medan,Laptop,240,165,75
2022,November,Medan,Printer,104,64,40
2022,November,Medan,Monitor,80,53,27
2022,November,Medan,Aksesori,181,121,60
2022,November,Medan,Server,165,99,66
2022,November,Denpasar,Laptop,69,52,17
2022,November,Denpasar,Printer,191,119,72
2022,November,Denpasar,Monitor,207,130,77
2022,November,Denpasar,Aksesori,177,129,48
2022,November,Denpasar,Server,237,164,73
2022,Desember,Jakarta,Laptop,183,116,67
2022,Desember,Jakarta,Printer,209,140,69
2022,Desember,Jakarta,Monitor,96,66,30
2022,Desember,Jakarta,Aksesori,287,207,80
2022,Desember,Jakarta,Server,211,133,78
2022,Desember,Bandung,Laptop,104,71,33
2022,Desember,Bandung,Printer,70,45,25
2022,Desember,Bandung,Monitor,181,128,53
2022,Desember,Bandung,Aksesori,124,81,43
2022,Desember,Bandung,Server,178,118,60
2022,Desember,Surabaya,Laptop,85,59,26
2022,Desember,Surabaya,Printer,228,159,69
2022,Desember,Surabaya,Monitor,299,186,113
2022,Desember,Surabaya,Aksesori,166,99,67
2022,Desember,Surabaya,Server,257,161,96
2022,Desember,Medan,Laptop,150,119,31
2022,Desember,Medan,Printer,89,65,24
2022,Desember,Medan,Monitor,189,141,48
2022,Desember,Medan,Aksesori,117,82,35
2022,Desember,Medan,Server,111,67,44
2022,Desember,Denpasar,Laptop,189,121,68
2022,Desember,Denpasar,Printer,94,66,28
2022,Desember,Denpasar,Monitor,292,224,68
2022,Desember,Denpasar,Aksesori,180,131,49
2022,Desember,Denpasar,Server,65,50,15
2023,Januari,Jakarta,Laptop,257,191,66
2023,Januari,Jakarta,Printer,273,187,86
2023,Januari,Jakarta,Monitor,154,108,46
2023,Januari,Jakarta,Aksesori,188,144,44
2023,Januari,Jakarta,Server,110,73,37
2023,Januari,Bandung,Laptop,261,190,71
2023,Januari,Bandung,Printer,196,141,55
2023,Januari,Bandung,Monitor,212,166,46
2023,Januari,Bandung,Aksesori,272,177,95
2023,Januari,Bandung,Server,118,91,27
2023,Januari,Surabaya,Laptop,267,165,102
2023,Januari,Surabaya,Printer,230,170,60
2023,Januari,Surabaya,Monitor,280,172,108
2023,Januari,Surabaya,Aksesori,232,140,92
2023,Januari,Surabaya,Server,62,44,18
2023,Januari,Medan,Laptop,147,110,37
2023,Januari,Medan,Printer,263,178,85
2023,Januari,Medan,Monitor,195,140,55
2023,Januari,Medan,Aksesori,62,44,18
2023,Januari,Medan,Server,175,136,39
2023,Januari,Denpasar,Laptop,93,74,19
2023,Januari,Denpasar,Printer,234,180,54
2023,Januari,Denpasar,Monitor,175,139,36
2023,Januari,Denpasar,Aksesori,290,187,103
2023,Januari,Denpasar,Server,189,138,51
2023,Februari,Jakarta,Laptop,121,83,38
2023,Februari,Jakarta,Printer,118,77,41
2023,Februari,Jakarta,Monitor,172,121,51
2023,Februari,Jakarta,Aksesori,224,169,55
2023,Februari,Jakarta,Server,170,119,51
2023,Februari,Bandung,Laptop,220,146,74
2023,Februari,Bandung,Printer,96,59,37
2023,Februari,Bandung,Monitor,186,118,68
2023,Februari,Bandung,Aksesori,214,135,79
2023,Februari,Bandung,Server,264,162,102
2023,Februari,Surabaya,Laptop,260,168,92
2023,Februari,Surabaya,Printer,231,168,63
2023,Februari,Surabaya,Monitor,107,77,30
2023,Februari,Surabaya,Aksesori,272,214,58
2023,Februari,Surabaya,Server,270,208,62
2023,Februari,Medan,Laptop,272,173,99
2023,Februari,Medan,Printer,147,106,41
2023,Februari,Medan,Monitor,82,51,31
2023,Februari,Medan,Aksesori,64,46,18
2023,Februari,Medan,Server,115,77,38
2023,Februari,Denpasar,Laptop,259,164,95
2023,Februari,Denpasar,Printer,156,119,37
2023,Februari,Denpasar,Monitor,232,146,86
2023,Februari,Denpasar,Aksesori,85,66,19
2023,Februari,Denpasar,Server,144,87,57
2023,Maret,Jakarta,Laptop,130,82,48
2023,Maret,Jakarta,Printer,231,158,73
2023,Maret,Jakarta,Monitor,299,195,104
2023,Maret,Jakarta,Aksesori,78,58,20
2023,Maret,Jakarta,Server,245,148,97
2023,Maret,Bandung,Laptop,110,74,36
2023,Maret,Bandung,Printer,75,56,19
2023,Maret,Bandung,Monitor,60,41,19
2023,Maret,Bandung,Aksesori,156,123,33
2023,Maret,Bandung,Server,169,120,49
2023,Maret,Surabaya,Laptop,270,163,107
2023,Maret,Surabaya,Printer,157,110,47
2023,Maret,Surabaya,Monitor,184,145,39
2023,Maret,Surabaya,Aksesori,147,106,41
2023,Maret,Surabaya,Server,235,178,57
2023,Maret,Medan,Laptop,113,77,36
2023,Maret,Medan,Printer,147,102,45
2023,Maret,Medan,Monitor,173,112,61
2023,Maret,Medan,Aksesori,127,79,48
2023,Maret,Medan,Server,264,182,82
2023,Maret,Denpasar,Laptop,253,201,52
2023,Maret,Denpasar,Printer,244,146,98
2023,Maret,Denpasar,Monitor,139,106,33
2023,Maret,Denpasar,Aksesori,225,163,62
2023,Maret,Denpasar,Server,92,61,31
2023,April,Jakarta,Laptop,227,177,50
2023,April,Jakarta,Printer,199,121,78
2023,April,Jakarta,Monitor,94,61,33
2023,April,Jakarta,Aksesori,216,146,70
2023,April,Jakarta,Server,211,161,50
2023,April,Bandung,Laptop,241,166,75
2023,April,Bandung,Printer,296,212,84
2023,April,Bandung,Monitor,188,142,46
2023,April,Bandung,Aksesori,221,157,64
2023,April,Bandung,Server,186,146,40
2023,April,Surabaya,Laptop,90,69,21
2023,April,Surabaya,Printer,268,180,88
2023,April,Surabaya,Monitor,151,91,60
2023,April,Surabaya,Aksesori,220,172,48
2023,April,Surabaya,Server,243,194,49
2023,April,Medan,Laptop,126,76,50
2023,April,Medan,Printer,128,82,46
2023,April,Medan,Monitor,95,65,30
2023,April,Medan,Aksesori,274,166,108
2023,April,Medan,Server,202,142,60
2023,April,Denpasar,Laptop,287,210,77
2023,April,Denpasar,Printer,271,188,83
2023,April,Denpasar,Monitor,265,198,67
2023,April,Denpasar,Aksesori,294,225,69
2023,April,Denpasar,Server,119,94,25
2023,Mei,Jakarta,Laptop,256,161,95
2023,Mei,Jakarta,Printer,253,163,90
2023,Mei,Jakarta,Monitor,216,148,68
2023,Mei,Jakarta,Aksesori,157,100,57
2023,Mei,Jakarta,Server,215,133,82
2023,Mei,Bandung,Laptop,153,97,56
2023,Mei,Bandung,Printer,244,192,52
2023,Mei,Bandung,Monitor,141,90,51
2023,Mei,Bandung,Aksesori,200,135,65
2023,Mei,Bandung,Server,66,46,20
2023,Mei,Surabaya,Laptop,200,139,61
2023,Mei,Surabaya,Printer,273,183,90
2023,Mei,Surabaya,Monitor,205,163,42
2023,Mei,Surabaya,Aksesori,69,42,27
2023,Mei,Surabaya,Server,236,179,57
2023,Mei,Medan,Laptop,288,227,61
2023,Mei,Medan,Printer,260,169,91
2023,Mei,Medan,Monitor,231,156,75
2023,Mei,Medan,Aksesori,104,74,30
2023,Mei,Medan,Server,123,93,30
2023,Mei,Denpasar,Laptop,158,123,35
2023,Mei,Denpasar,Printer,96,61,35
2023,Mei,Denpasar,Monitor,199,143,56
2023,Mei,Denpasar,Aksesori,81,52,29
2023,Mei,Denpasar,Server,194,151,43
2023,Juni,Jakarta,Laptop,190,129,61
2023,Juni,Jakarta,Printer,275,181,94
2023,Juni,Jakarta,Monitor,224,166,58
2023,Juni,Jakarta,Aksesori,61,44,17
2023,Juni,Jakarta,Server,80,50,30
2023,Juni,Bandung,Laptop,127,78,49
2023,Juni,Bandung,Printer,201,139,62
2023,Juni,Bandung,Monitor,161,104,57
2023,Juni,Bandung,Aksesori,290,180,110
2023,Juni,Bandung,Server,143,86,57
2023,Juni,Surabaya,Laptop,86,59,27
2023,Juni,Surabaya,Printer,230,148,82
2023,Juni,Surabaya,Monitor,121,90,31
2023,Juni,Surabaya,Aksesori,120,92,28
2023,Juni,Surabaya,Server,152,92,60
2023,Juni,Medan,Laptop,193,149,44
2023,Juni,Medan,Printer,263,161,102
2023,Juni,Medan,Monitor,190,143,47
2023,Juni,Medan,Aksesori,191,125,66
2023,Juni,Medan,Server,76,51,25
2023,Juni,Denpasar,Laptop,100,68,32
2023,Juni,Denpasar,Printer,280,222,58
2023,Juni,Denpasar,Monitor,134,107,27
2023,Juni,Denpasar,Aksesori,92,67,25
2023,Juni,Denpasar,Server,116,82,34
2023,Juli,Jakarta,Laptop,137,92,45
2023,Juli,Jakarta,Printer,183,144,39
2023,Juli,Jakarta,Monitor,274,174,100
2023,Juli,Jakarta,Aksesori,151,105,46
2023,Juli,Jakarta,Server,129,89,40
2023,Juli,Bandung,Laptop,234,163,71
2023,Juli,Bandung,Printer,231,180,51
2023,Juli,Bandung,Monitor,158,120,38
2023,Juli,Bandung,Aksesori,134,100,34
2023,Juli,Bandung,Server,157,123,34
2023,Juli,Surabaya,Laptop,292,195,97
2023,Juli,Surabaya,Printer,79,55,24
2023,Juli,Surabaya,Monitor,68,43,25
2023,Juli,Surabaya,Aksesori,184,111,73
2023,Juli,Surabaya,Server,124,80,44
2023,Juli,Medan,Laptop,163,107,56
2023,Juli,Medan,Printer,288,176,112
2023,Juli,Medan,Monitor,75,51,24
2023,Juli,Medan,Aksesori,88,64,24
2023,Juli,Medan,Server,88,58,30
2023,Juli,Denpasar,Laptop,108,80,28
2023,Juli,Denpasar,Printer,128,78,50
2023,Juli,Denpasar,Monitor,118,93,25
2023,Juli,Denpasar,Aksesori,99,68,31
2023,Juli,Denpasar,Server,134,100,34
2023,Agustus,Jakarta,Laptop,265,198,67
2023,Agustus,Jakarta,Printer,297,196,101
2023,Agustus,Jakarta,Monitor,162,126,36
2023,Agustus,Jakarta,Aksesori,158,103,55
2023,Agustus,Jakarta,Server,148,99,49
2023,Agustus,Bandung,Laptop,282,196,86
2023,Agustus,Bandung,Printer,154,121,33
2023,Agustus,Bandung,Monitor,155,103,52
2023,Agustus,Bandung,Aksesori,231,149,82
2023,Agustus,Bandung,Server,176,131,45
2023,Agustus,Surabaya,Laptop,267,189,78
2023,Agustus,Surabaya,Printer,285,182,103
2023,Agustus,Surabaya,Monitor,76,58,18
2023,Agustus,Surabaya,Aksesori,290,222,68
2023,Agustus,Surabaya,Server,281,182,99
2023,Agustus,Medan,Laptop,257,183,74
2023,Agustus,Medan,Printer,266,191,75
2023,Agustus,Medan,Monitor,109,84,25
2023,Agustus,Medan,Aksesori,281,221,60
2023,Agustus,Medan,Server,114,77,37
2023,Agustus,Denpasar,Laptop,140,96,44
2023,Agustus,Denpasar,Printer,221,168,53
2023,Agustus,Denpasar,Monitor,215,133,82
2023,Agustus,Denpasar,Aksesori,202,146,56
2023,Agustus,Denpasar,Server,175,125,50
2023,September,Jakarta,Laptop,287,172,115
2023,September,Jakarta,Printer,177,124,53
2023,September,Jakarta,Monitor,66,44,22
2023,September,Jakarta,Aksesori,131,88,43
2023,September,Jakarta,Server,122,95,27
2023,September,Bandung,Laptop,218,165,53
2023,September,Bandung,Printer,205,156,49
2023,September,Bandung,Monitor,296,205,91
2023,September,Bandung,Aksesori,73,49,24
2023,September,Bandung,Server,98,75,23
2023,September,Surabaya,Laptop,261,195,66
2023,September,Surabaya,Printer,88,60,28
2023,September,Surabaya,Monitor,82,59,23
2023,September,Surabaya,Aksesori,93,59,34
2023,September,Surabaya,Server,253,196,57
2023,September,Medan,Laptop,95,74,21
2023,September,Medan,Printer,295,229,66
2023,September,Medan,Monitor,253,155,98
2023,September,Medan,Aksesori,68,42,26
2023,September,Medan,Server,169,111,58
2023,September,Denpasar,Laptop,118,76,42
2023,September,Denpasar,Printer,76,59,17
2023,September,Denpasar,Monitor,60,44,16
2023,September,Denpasar,Aksesori,85,60,25
2023,September,Denpasar,Server,72,44,28
2023,Oktober,Jakarta,Laptop,280,202,78
2023,Oktober,Jakarta,Printer,86,51,35
2023,Oktober,Jakarta,Monitor,245,165,80
2023,Oktober,Jakarta,Aksesori,62,42,20
2023,Oktober,Jakarta,Server,197,137,60
2023,Oktober,Bandung,Laptop,253,159,94
2023,Oktober,Bandung,Printer,82,60,22
2023,Oktober,Bandung,Monitor,193,125,68
2023,Oktober,Bandung,Aksesori,211,159,52
2023,Oktober,Bandung,Server,242,158,84
2023,Oktober,Surabaya,Laptop,120,76,44
2023,Oktober,Surabaya,Printer,233,175,58
2023,Oktober,Surabaya,Monitor,62,45,17
2023,Oktober,Surabaya,Aksesori,130,94,36
2023,Oktober,Surabaya,Server,105,80,25
2023,Oktober,Medan,Laptop,144,95,49
2023,Oktober,Medan,Printer,272,199,73
2023,Oktober,Medan,Monitor,100,63,37
2023,Oktober,Medan,Aksesori,209,125,84
2023,Oktober,Medan,Server,144,86,58
2023,Oktober,Denpasar,Laptop,177,112,65
2023,Oktober,Denpasar,Printer,234,158,76
2023,Oktober,Denpasar,Monitor,162,110,52
2023,Oktober,Denpasar,Aksesori,93,69,24
2023,Oktober,Denpasar,Server,145,115,30
2023,November,Jakarta,Laptop,81,60,21
2023,November,Jakarta,Printer,93,62,31
2023,November,Jakarta,Monitor,246,181,65
2023,November,Jakarta,Aksesori,150,113,37
2023,November,Jakarta,Server,192,126,66
2023,November,Bandung,Laptop,108,66,42
2023,November,Bandung,Printer,185,124,61
2023,November,Bandung,Monitor,81,58,23
2023,November,Bandung,Aksesori,74,50,24
2023,November,Bandung,Server,71,43,28
2023,November,Surabaya,Laptop,181,132,49
2023,November,Surabaya,Printer,172,132,40
2023,November,Surabaya,Monitor,97,61,36
2023,November,Surabaya,Aksesori,159,98,61
2023,November,Surabaya,Server,85,63,22
2023,November,Medan,Laptop,212,148,64
2023,November,Medan,Printer,241,179,62
2023,November,Medan,Monitor,119,78,41
2023,November,Medan,Aksesori,133,89,44
2023,November,Medan,Server,226,140,86
2023,November,Denpasar,Laptop,211,151,60
2023,November,Denpasar,Printer,168,116,52
2023,November,Denpasar,Monitor,141,97,44
2023,November,Denpasar,Aksesori,181,111,70
2023,November,Denpasar,Server,106,73,33
2023,Desember,Jakarta,Laptop,194,119,75
2023,Desember,Jakarta,Printer,255,172,83
2023,Desember,Jakarta,Monitor,214,158,56
2023,Desember,Jakarta,Aksesori,124,75,49
2023,Desember,Jakarta,Server,198,154,44
2023,Desember,Bandung,Laptop,171,118,53
2023,Desember,Bandung,Printer,281,216,65
2023,Desember,Bandung,Monitor,105,63,42
2023,Desember,Bandung,Aksesori,279,221,58
2023,Desember,Bandung,Server,284,218,66
2023,Desember,Surabaya,Laptop,258,163,95
2023,Desember,Surabaya,Printer,239,172,67
2023,Desember,Surabaya,Monitor,61,38,23
2023,Desember,Surabaya,Aksesori,102,78,24
2023,Desember,Surabaya,Server,218,149,69
2023,Desember,Medan,Laptop,182,115,67
2023,Desember,Medan,Printer,101,74,27
2023,Desember,Medan,Monitor,257,171,86
2023,Desember,Medan,Aksesori,292,221,71
2023,Desember,Medan,Server,128,90,38
2023,Desember,Denpasar,Laptop,291,200,91
2023,Desember,Denpasar,Printer,181,122,59
2023,Desember,Denpasar,Monitor,100,61,39
2023,Desember,Denpasar,Aksesori,240,176,64
2023,Desember,Denpasar,Server,260,165,95
2024,Januari,Jakarta,Laptop,73,55,18
2024,Januari,Jakarta,Printer,163,117,46
2024,Januari,Jakarta,Monitor,291,209,82
2024,Januari,Jakarta,Aksesori,111,80,31
2024,Januari,Jakarta,Server,230,151,79
2024,Januari,Bandung,Laptop,289,217,72
2024,Januari,Bandung,Printer,210,144,66
2024,Januari,Bandung,Monitor,205,134,71
2024,Januari,Bandung,Aksesori,86,64,22
2024,Januari,Bandung,Server,84,65,19
2024,Januari,Surabaya,Laptop,245,180,65
2024,Januari,Surabaya,Printer,216,171,45
2024,Januari,Surabaya,Monitor,144,109,35
2024,Januari,Surabaya,Aksesori,248,183,65
2024,Januari,Surabaya,Server,137,104,33
2024,Januari,Medan,Laptop,122,84,38
2024,Januari,Medan,Printer,108,67,41
2024,Januari,Medan,Monitor,284,194,90
2024,Januari,Medan,Aksesori,195,141,54
2024,Januari,Medan,Server,268,163,105
2024,Januari,Denpasar,Laptop,125,99,26
2024,Januari,Denpasar,Printer,265,209,56
2024,Januari,Denpasar,Monitor,113,88,25
2024,Januari,Denpasar,Aksesori,300,198,102
2024,Januari,Denpasar,Server,143,102,41
2024,Februari,Jakarta,Laptop,144,103,41
2024,Februari,Jakarta,Printer,85,57,28
2024,Februari,Jakarta,Monitor,155,114,41
2024,Februari,Jakarta,Aksesori,176,126,50
2024,Februari,Jakarta,Server,108,68,40
2024,Februari,Bandung,Laptop,194,138,56
2024,Februari,Bandung,Printer,295,223,72
2024,Februari,Bandung,Monitor,109,79,30
2024,Februari,Bandung,Aksesori,209,132,77
2024,Februari,Bandung,Server,128,88,40
2024,Februari,Surabaya,Laptop,96,74,22
2024,Februari,Surabaya,Printer,237,169,68
2024,Februari,Surabaya,Monitor,179,113,66
2024,Februari,Surabaya,Aksesori,195,154,41
2024,Februari,Surabaya,Server,76,57,19
2024,Februari,Medan,Laptop,205,135,70
2024,Februari,Medan,Printer,296,209,87
2024,Februari,Medan,Monitor,166,108,58
2024,Februari,Medan,Aksesori,225,139,86
2024,Februari,Medan,Server,296,233,63
2024,Februari,Denpasar,Laptop,239,157,82
2024,Februari,Denpasar,Printer,222,162,60
2024,Februari,Denpasar,Monitor,183,125,58
2024,Februari,Denpasar,Aksesori,158,101,57
2024,Februari,Denpasar,Server,84,60,24
2024,Maret,Jakarta,Laptop,135,103,32
2024,Maret,Jakarta,Printer,148,90,58
2024,Maret,Jakarta,Monitor,80,50,30
2024,Maret,Jakarta,Aksesori,160,115,45
2024,Maret,Jakarta,Server,205,136,69
2024,Maret,Bandung,Laptop,110,66,44
2024,Maret,Bandung,Printer,84,63,21
2024,Maret,Bandung,Monitor,214,154,60
2024,Maret,Bandung,Aksesori,259,170,89
2024,Maret,Bandung,Server,295,219,76
2024,Maret,Surabaya,Laptop,239,162,77
2024,Maret,Surabaya,Printer,185,132,53
2024,Maret,Surabaya,Monitor,70,45,25
2024,Maret,Surabaya,Aksesori,259,199,60
2024,Maret,Surabaya,Server,207,156,51
2024,Maret,Medan,Laptop,275,200,75
2024,Maret,Medan,Printer,90,69,21
2024,Maret,Medan,Monitor,249,166,83
2024,Maret,Medan,Aksesori,168,104,64
2024,Maret,Medan,Server,208,152,56
2024,Maret,Denpasar,Laptop,251,162,89
2024,Maret,Denpasar,Printer,159,108,51
2024,Maret,Denpasar,Monitor,69,50,19
2024,Maret,Denpasar,Aksesori,252,195,57
2024,Maret,Denpasar,Server,150,92,58
2024,April,Jakarta,Laptop,154,101,53
2024,April,Jakarta,Printer,224,142,82
2024,April,Jakarta,Monitor,242,177,65
2024,April,Jakarta,Aksesori,170,109,61
2024,April,Jakarta,Server,252,161,91
2024,April,Bandung,Laptop,196,131,65
2024,April,Bandung,Printer,181,127,54
2024,April,Bandung,Monitor,222,145,77
2024,April,Bandung,Aksesori,269,202,67
2024,April,Bandung,Server,108,74,34
2024,April,Surabaya,Laptop,267,205,62
2024,April,Surabaya,Printer,102,77,25
2024,April,Surabaya,Monitor,295,225,70
2024,April,Surabaya,Aksesori,61,43,18
2024,April,Surabaya,Server,62,49,13
2024,April,Medan,Laptop,209,165,44
2024,April,Medan,Printer,235,159,76
2024,April,Medan,Monitor,259,190,69
2024,April,Medan,Aksesori,112,70,42
2024,April,Medan,Server,85,65,20
2024,April,Denpasar,Laptop,92,71,21
2024,April,Denpasar,Printer,84,57,27
2024,April,Denpasar,Monitor,213,143,70
2024,April,Denpasar,Aksesori,106,82,24
2024,April,Denpasar,Server,161,99,62
2024,Mei,Jakarta,Laptop,174,119,55
2024,Mei,Jakarta,Printer,221,176,45
2024,Mei,Jakarta,Monitor,226,149,77
2024,Mei,Jakarta,Aksesori,206,131,75
2024,Mei,Jakarta,Server,204,130,74
2024,Mei,Bandung,Laptop,228,166,62
2024,Mei,Bandung,Printer,252,196,56
2024,Mei,Bandung,Monitor,253,171,82
2024,Mei,Bandung,Aksesori,160,103,57
2024,Mei,Bandung,Server,183,142,41
2024,Mei,Surabaya,Laptop,128,80,48
2024,Mei,Surabaya,Printer,134,105,29
2024,Mei,Surabaya,Monitor,258,183,75
2024,Mei,Surabaya,Aksesori,152,106,46
2024,Mei,Surabaya,Server,68,41,27
2024,Mei,Medan,Laptop,108,79,29
2024,Mei,Medan,Printer,66,43,23
2024,Mei,Medan,Monitor,207,135,72
2024,Mei,Medan,Aksesori,137,100,37
2024,Mei,Medan,Server,106,71,35
2024,Mei,Denpasar,Laptop,119,79,40
2024,Mei,Denpasar,Printer,257,169,88
2024,Mei,Denpasar,Monitor,167,100,67
2024,Mei,Denpasar,Aksesori,226,137,89
2024,Mei,Denpasar,Server,182,114,68
2024,Juni,Jakarta,Laptop,285,222,63
2024,Juni,Jakarta,Printer,104,74,30
2024,Juni,Jakarta,Monitor,262,207,55
2024,Juni,Jakarta,Aksesori,191,145,46
2024,Juni,Jakarta,Server,194,135,59
2024,Juni,Bandung,Laptop,94,68,26
2024,Juni,Bandung,Printer,67,50,17
2024,Juni,Bandung,Monitor,87,53,34
2024,Juni,Bandung,Aksesori,233,146,87
2024,Juni,Bandung,Server,118,79,39
2024,Juni,Surabaya,Laptop,235,166,69
2024,Juni,Surabaya,Printer,114,79,35
2024,Juni,Surabaya,Monitor,267,199,68
2024,Juni,Surabaya,Aksesori,84,50,34
2024,Juni,Surabaya,Server,245,172,73
2024,Juni,Medan,Laptop,194,138,56
2024,Juni,Medan,Printer,88,70,18
2024,Juni,Medan,Monitor,84,57,27
2024,Juni,Medan,Aksesori,294,198,96
2024,Juni,Medan,Server,207,163,44
2024,Juni,Denpasar,Laptop,160,115,45
2024,Juni,Denpasar,Printer,294,198,96
2024,Juni,Denpasar,Monitor,223,142,81
2024,Juni,Denpasar,Aksesori,268,210,58
2024,Juni,Denpasar,Server,228,166,62
2024,Juli,Jakarta,Laptop,230,166,64
2024,Juli,Jakarta,Printer,68,44,24
2024,Juli,Jakarta,Monitor,61,48,13
2024,Juli,Jakarta,Aksesori,106,71,35
2024,Juli,Jakarta,Server,102,73,29
2024,Juli,Bandung,Laptop,86,68,18
2024,Juli,Bandung,Printer,178,141,37
2024,Juli,Bandung,Monitor,244,156,88
2024,Juli,Bandung,Aksesori,147,100,47
2024,Juli,Bandung,Server,197,137,60
2024,Juli,Surabaya,Laptop,299,182,117
2024,Juli,Surabaya,Printer,119,94,25
2024,Juli,Surabaya,Monitor,256,196,60
2024,Juli,Surabaya,Aksesori,82,61,21
2024,Juli,Surabaya,Server,146,88,58
2024,Juli,Medan,Laptop,223,143,80
2024,Juli,Medan,Printer,276,184,92
2024,Juli,Medan,Monitor,230,162,68
2024,Juli,Medan,Aksesori,131,79,52
2024,Juli,Medan,Server,286,212,74
2024,Juli,Denpasar,Laptop,156,105,51
2024,Juli,Denpasar,Printer,121,81,40
2024,Juli,Denpasar,Monitor,260,167,93
2024,Juli,Denpasar,Aksesori,125,80,45
2024,Juli,Denpasar,Server,134,85,49
2024,Agustus,Jakarta,Laptop,159,102,57
2024,Agustus,Jakarta,Printer,290,200,90
2024,Agustus,Jakarta,Monitor,289,182,107
2024,Agustus,Jakarta,Aksesori,283,197,86
2024,Agustus,Jakarta,Server,228,146,82
2024,Agustus,Bandung,Laptop,96,67,29
2024,Agustus,Bandung,Printer,173,112,61
2024,Agustus,Bandung,Monitor,89,62,27
2024,Agustus,Bandung,Aksesori,139,101,38
2024,Agustus,Bandung,Server,193,146,47
2024,Agustus,Surabaya,Laptop,132,79,53
2024,Agustus,Surabaya,Printer,219,140,79
2024,Agustus,Surabaya,Monitor,250,197,53
2024,Agustus,Surabaya,Aksesori,230,138,92
2024,Agustus,Surabaya,Server,134,91,43
2024,Agustus,Medan,Laptop,146,95,51
2024,Agustus,Medan,Printer,220,163,57
2024,Agustus,Medan,Monitor,194,146,48
2024,Agustus,Medan,Aksesori,198,150,48
2024,Agustus,Medan,Server,119,92,27
2024,Agustus,Denpasar,Laptop,181,139,42
2024,Agustus,Denpasar,Printer,291,195,96
2024,Agustus,Denpasar,Monitor,279,200,79
2024,Agustus,Denpasar,Aksesori,150,93,57
2024,Agustus,Denpasar,Server,157,119,38
2024,September,Jakarta,Laptop,260,169,91
2024,September,Jakarta,Printer,94,58,36
2024,September,Jakarta,Monitor,120,78,42
2024,September,Jakarta,Aksesori,252,195,57
2024,September,Jakarta,Server,252,189,63
2024,September,Bandung,Laptop,82,55,27
2024,September,Bandung,Printer,263,184,79
2024,September,Bandung,Monitor,300,213,87
2024,September,Bandung,Aksesori,114,75,39
2024,September,Bandung,Server,217,134,83
2024,September,Surabaya,Laptop,179,130,49
2024,September,Surabaya,Printer,93,69,24
2024,September,Surabaya,Monitor,98,73,25
2024,September,Surabaya,Aksesori,186,121,65
2024,September,Surabaya,Server,212,137,75
2024,September,Medan,Laptop,126,87,39
2024,September,Medan,Printer,75,45,30
2024,September,Medan,Monitor,235,147,88
2024,September,Medan,Aksesori,125,94,31
2024,September,Medan,Server,151,120,31
2024,September,Denpasar,Laptop,204,129,75
2024,September,Denpasar,Printer,99,76,23
2024,September,Denpasar,Monitor,149,100,49
2024,September,Denpasar,Aksesori,68,47,21
2024,September,Denpasar,Server,88,67,21
2024,Oktober,Jakarta,Laptop,246,148,98
2024,Oktober,Jakarta,Printer,88,59,29
2024,Oktober,Jakarta,Monitor,257,165,92
2024,Oktober,Jakarta,Aksesori,81,53,28
2024,Oktober,Jakarta,Server,204,152,52
2024,Oktober,Bandung,Laptop,112,84,28
2024,Oktober,Bandung,Printer,123,74,49
2024,Oktober,Bandung,Monitor,219,160,59
2024,Oktober,Bandung,Aksesori,108,76,32
2024,Oktober,Bandung,Server,150,116,34
2024,Oktober,Surabaya,Laptop,265,192,73
2024,Oktober,Surabaya,Printer,208,135,73
2024,Oktober,Surabaya,Monitor,64,42,22
2024,Oktober,Surabaya,Aksesori,219,145,74
2024,Oktober,Surabaya,Server,103,81,22
2024,Oktober,Medan,Laptop,150,98,52
2024,Oktober,Medan,Printer,184,128,56
2024,Oktober,Medan,Monitor,121,82,39
2024,Oktober,Medan,Aksesori,124,74,50
2024,Oktober,Medan,Server,296,216,80
2024,Oktober,Denpasar,Laptop,86,68,18
2024,Oktober,Denpasar,Printer,202,135,67
2024,Oktober,Denpasar,Monitor,229,140,89
2024,Oktober,Denpasar,Aksesori,189,131,58
2024,Oktober,Denpasar,Server,99,67,32
2024,November,Jakarta,Laptop,196,153,43
2024,November,Jakarta,Printer,83,57,26
2024,November,Jakarta,Monitor,202,161,41
2024,November,Jakarta,Aksesori,214,136,78
2024,November,Jakarta,Server,260,173,87
2024,November,Bandung,Laptop,190,125,65
2024,November,Bandung,Printer,272,196,76
2024,November,Bandung,Monitor,133,103,30
2024,November,Bandung,Aksesori,165,125,40
2024,November,Bandung,Server,116,84,32
2024,November,Surabaya,Laptop,186,137,49
2024,November,Surabaya,Printer,240,179,61
2024,November,Surabaya,Monitor,253,200,53
2024,November,Surabaya,Aksesori,169,127,42
2024,November,Surabaya,Server,140,93,47
2024,November,Medan,Laptop,107,79,28
2024,November,Medan,Printer,289,195,94
2024,November,Medan,Monitor,133,83,50
2024,November,Medan,Aksesori,276,188,88
2024,November,Medan,Server,219,156,63
2024,November,Denpasar,Laptop,90,61,29
2024,November,Denpasar,Printer,179,128,51
2024,November,Denpasar,Monitor,175,128,47
2024,November,Denpasar,Aksesori,248,161,87
2024,November,Denpasar,Server,135,83,52
2024,Desember,Jakarta,Laptop,190,118,72
2024,Desember,Jakarta,Printer,78,60,18
2024,Desember,Jakarta,Monitor,288,223,65
2024,Desember,Jakarta,Aksesori,258,197,61
2024,Desember,Jakarta,Server,186,115,71
2024,Desember,Bandung,Laptop,149,99,50
2024,Desember,Bandung,Printer,122,84,38
2024,Desember,Bandung,Monitor,195,132,63
2024,Desember,Bandung,Aksesori,284,217,67
2024,Desember,Bandung,Server,298,186,112
2024,Desember,Surabaya,Laptop,135,101,34
2024,Desember,Surabaya,Printer,241,184,57
2024,Desember,Surabaya,Monitor,262,192,70
2024,Desember,Surabaya,Aksesori,116,77,39
2024,Desember,Surabaya,Server,273,174,99
2024,Desember,Medan,Laptop,93,57,36
2024,Desember,Medan,Printer,84,62,22
2024,Desember,Medan,Monitor,106,68,38
2024,Desember,Medan,Aksesori,273,211,62
2024,Desember,Medan,Server,82,53,29
2024,Desember,Denpasar,Laptop,74,44,30
2024,Desember,Denpasar,Printer,105,69,36
2024,Desember,Denpasar,Monitor,159,97,62
2024,Desember,Denpasar,Aksesori,68,44,24
2024,Desember,Denpasar,Server,125,99,26
